33233333233-
33233333233-
33233033233-
33230103233-
33330103333-
00030103000-
11030003011-
11033333011
